2 2 2 2 2 2 2 2 2 2
2 5 4 6 3 3 3 4 2 2
2 3 6 3 3 3 3 3 3 2
2 3 3 3 2 3 3 3 3 2
2 3 3 3 2 3 3 3 3 2
2 3 3 3 2 3 3 3 3 2
2 3 3 3 3 3 3 3 2 2
2 3 3 3 3 3 3 3 3 2
2 3 3 3 2 2 3 3 3 2
2 2 2 2 2 2 2 2 2 2
